5 11
00000100000
00011111000
00111111100
01111111110
11111111111