7 11
10000000001
01000000010
00100000100
00010001000
00100000100
01000000010
10000000001